000000000000000000
011111111111100000
000001000000100000
000001000000100000
000001111111110000
000001000010000000
000001000010000000
000001000010000000
000001000010000000
000001000010000000
000111111111110000
000100000000010000
000100000000010000
000000000000000000