000000000000000000
000064160011160000
000010010010010000
000010010010010000
000010010010010000
000010010010010000
161560061160061161
000010010010010000
000010010010010000
000010010010010000
000010010010010000
000010010010010000
000061160061160000
000000000000000000