000000000000000000
042222222322200000
000002000000200000
000002000000200000
000002222222220000
000002000020000000
000002000020000000
000002000020000000
000002000020000000
000002000020000000
000222222322220000
000200000000020000
000200000000020000
000000000000000000