11111111111100000
00001000000100000
00001000000100000
00001111111110000
00001000010000000
00001000010000000
00001000010000000
00001000010000000
00001000010000000
00111111111110000
00100000000010000
00100000000010000
00100000000010000
11111110000011111
00000010000010000
00000011111110000
00000000000000000