000000000000000000
022222222322200000
000002000000200000
000002000000200000
222222242222222222
000002000020000000
000002000020000000
000002000020000000
000002000020000000
000002000020000000
000225222322220000
000200000000020000
000200000000020000
000000000000000000