000000000000000000
001221122311200000
000002000000200000
000002000000200000
211111242112111111
000002000020000000
000001000010000000
000001000010000000
000001000020000000
000002000020000000
000225211321120000
000100000000020000
000200000000020000
000000000000000000