000000000000000000
006212600000612160
001000500000100010
066000100000100010
010000613211600010
010000100000000010
161211614132112161
010000000000000010
010061212312112160
010010000000000000
010061121212312160
010000000000000010
061211211121131160
000000000000000000